WWWWWWWWWWWWWWWWWWWWWWWWWWWWWWWWWWWWWWWWW
W.......................................W
W.......................................W
W.......................................W
W.......................................W
W....W.............................W....W
W.......................................W
W.......................................W
W.......................................W
W.......................................W
W.......................................W
W.......................................W
W.......................................W
W.......................................W
W....W.............................W....W
W.......................................W
W.......................................W
W.......................................W
W.......................................W
WWWWWWWWWWWWWWWWWWWWWWWWWWWWWWWWWWWWWWWWW


